11111111111111111111111111111111111111111111111111111111111111111111111111111111
101110001110111100000111011101110111111011110011110010010000011010E0101010111101
11110110101000010110101101010100110010000111100110101110011010100111111111101011
10101011111011001111101000001010111111111101100000010111010100000100011101011011
10011011100000100010001000110000010011010011110011111000111100010101011011110101
10101111110011101100111111011010010010000101110010111000001101011011011111001111
10111101111000100011100111001101001111010000000001000000101111000010101011111111
10000011110011100011100011001010011010101100101001011010010011011011110110101111
11010011011000001111111011001000001110011111110010000001110010011010010111000011
10000100111111000011110001011101011000111010101000011010001101010101001110001101
11111101111110111100101001100111100010001111110001010111101111000110110000010001
10010010100001100111110101101011100101100010101011000010011111111101110100011011
10001001001111110101010001001010110000011110001101001111010011000110110011101011
11001000111010000111001001010100100010PC0010000011011010100001100000000101100001
10001001001000010111111000011101110001010000111010010100111101101111100111100101
10011000010011101010100001000110111110010101111001000100010100010011010110101011
10000011100111010100101001000001110000001100000110010101001101110000101110111111
10000011111001011111110011111000100010001010110101101111110001010100010001101111
10101001111100011010110110100110010001000000101010111110111001011011010000011011
11100110011110100001011001101110110000010100101101011111100011010100100110001111
11100100101000000000001101100010110111010100100010010000000111101100111101011101
11110101100000110000001111101101001001100101111101111111100010111110111001111111
10010100011010100000100101010000111110011010101111100011111010110010100101010011
10011010110011101110100100110100011100000111000000100100100001010100000101000001
10111000010101110011011100010100010011011001100010000100001100100001010101010111
11001100101010000011101111111010011001001000000010110110101000101000010101110111
11011111100100100100110100111101101011001011001100000011110000011011101111101111
10011001111000001101011110001011101000010101110101110001111011001100111110101101
10111000001010111001100010101010000110100011001110010100001110110001111110110001
11010001110111110001011000000000100011001011011101000111111000100110011000111101
10111001000010000100001100011111101110111000100101001111101000001100011010110101
10010001000010001000000111101001100101000110011110001111011011010101101100101111
10100111101110110000101010010000101110101010110101010000100010101011101001001011
11101111000011100010001000110111001000111110100010000010100101110110110011010001
11011010100001111010001011101100100100110100001011001000110000000001011000010011
11111111111111111111111111111111111111111111111111111111111111111111111111111111