11111111111111111111111111111111111111111
1CCCCCC1CCCCCCCCCCCCCCCCCCCCCCCCCCCCCCCC1
1C111C111111111C111111111111111C111111111
1C111C111111111C111111111111111C111111111
1CCCCC111111111CCCCCCCCCCCCCCCCCCCCCCCCC1
11111C111CCCCCCC1111111C11111110000000001
11111C111C11111C1111111C11111110111001111
11111C111C11111C1100011C11000110100000011
1PCCCC111CCC111C1100011C11000110100CC0011
11111C111111111C1100011C11000110111111111
11111C111111111C1111111C111111100000000E1
11111C111111111C1111111C11111110111111111
1CCCCCCCCCCCCCCCCCCCCCCCCCCCCCCC111111111
1C1111C1111111111C11C1111111111CCCC11CCC1
1C1111C1111111111C11C1111111111C11C11C111
1CCCCCCCCCCCCCCCCC11CCCCCCCCCCCC11CCCC111
11111111111111111111111111111111111111111