1111111
1PC1CG1
1CC11C1
1CC1CC1
1CC1C01
1ECCCC1
1111111